21 21 32 21 21 21 21 21 21 32 32 32 21 21 21 32 32 21 32 21 21 32 21 25 17 17 3 43 19 58 58 58 58 58 58 58 58 58 19 58 38 35 3 17 17 17 17 17 17 31 21 21 21 21 32 21 21 32 21 21 21 21 21 32 32 32 21 21 32 21 21 0 0 0 0 0 0 0 0 0 0 0 0 0 0 0 0 0 0 0 0 0 0 0 0 0 0 0 0 0 
32 21 52 48 48 48 48 48 48 48 48 48 48 48 48 48 48 48 48 48 48 54 31 25 17 17 33 40 58 58 58 19 58 58 19 19 58 58 58 58 19 44 16 17 17 16 17 17 17 31 25 52 48 48 48 48 48 48 48 48 48 48 48 48 48 48 48 48 48 54 31 0 0 0 0 0 0 0 0 0 0 0 0 0 0 0 0 0 0 0 0 0 0 0 0 0 0 0 0 0 
21 25 49 45 45 47 45 45 45 45 45 45 45 45 45 45 45 45 45 45 45 51 26 30 17 3 43 58 58 58 58 58 58 58 58 58 58 58 58 58 58 44 12 16 17 17 17 17 17 31 25 49 47 45 45 45 45 45 45 45 46 45 45 45 45 45 45 45 45 51 31 0 0 0 0 0 0 0 0 0 0 0 0 0 0 0 0 0 0 0 0 0 0 0 0 0 0 0 0 0 
32 30 49 45 45 45 45 45 45 45 45 45 45 45 45 45 45 45 47 45 45 51 31 25 17 33 40 58 19 58 58 58 58 58 58 58 58 58 19 58 58 38 35 3 17 17 16 17 12 26 30 49 45 45 45 45 45 45 45 45 45 45 45 45 45 45 45 45 45 51 31 0 0 0 0 0 0 0 0 0 0 0 0 0 0 0 0 0 0 0 0 0 0 0 0 0 0 0 0 0 
21 30 49 45 45 45 45 45 45 45 45 47 45 45 45 45 45 45 45 45 45 51 26 25 17 43 19 58 58 58 58 58 19 19 58 58 58 58 58 19 58 58 44 3 3 17 17 17 12 26 25 49 45 45 45 45 45 45 45 45 45 45 45 45 45 45 45 45 45 51 31 0 0 0 0 0 0 0 0 0 0 0 0 0 0 0 0 0 0 0 0 0 0 0 0 0 0 0 0 0 
21 25 49 45 45 45 46 45 45 45 45 45 45 45 45 45 45 45 45 45 45 51 26 30 17 43 58 58 58 58 58 58 58 58 58 58 58 58 58 58 58 58 44 12 12 17 17 17 17 31 25 49 45 45 45 45 45 45 45 45 45 45 47 45 45 45 45 46 45 51 26 0 0 0 0 0 0 0 0 0 0 0 0 0 0 0 0 0 0 0 0 0 0 0 0 0 0 0 0 0 
32 25 49 45 45 45 45 45 45 45 45 45 45 45 45 45 45 45 45 45 45 51 26 30 17 43 19 19 58 58 58 58 58 58 58 58 58 58 58 58 58 58 38 42 42 35 3 17 17 26 25 49 45 45 45 46 45 45 45 45 45 45 45 45 45 45 45 45 45 51 26 0 0 0 0 0 0 0 0 0 0 0 0 0 0 0 0 0 0 0 0 0 0 0 0 0 0 0 0 0 
21 30 49 45 45 45 45 45 45 45 45 45 47 45 45 45 45 45 47 45 45 51 26 30 17 34 39 58 58 19 19 58 58 58 58 19 19 58 58 58 58 58 58 58 19 38 35 12 17 26 30 53 50 50 50 50 50 50 50 56 45 45 45 45 45 45 45 45 45 51 26 0 0 0 0 0 0 0 0 0 0 0 0 0 0 0 0 0 0 0 0 0 0 0 0 0 0 0 0 0 
21 25 49 47 45 45 45 45 45 45 45 45 45 45 45 45 45 45 45 45 45 51 31 25 17 3 43 58 58 58 58 58 58 58 58 58 58 58 58 58 19 19 58 58 58 19 38 35 17 31 21 21 21 32 32 21 32 21 21 49 45 45 45 45 45 45 45 45 45 51 31 0 0 0 0 0 0 0 0 0 0 0 0 0 0 0 0 0 0 0 0 0 0 0 0 0 0 0 0 0 
21 30 49 45 45 45 45 47 45 45 45 45 45 45 45 45 45 45 45 45 45 51 26 25 17 3 43 19 58 58 58 58 58 58 58 19 19 58 58 58 58 58 58 58 58 58 19 38 35 17 17 17 16 17 17 17 12 12 26 49 45 45 46 45 45 45 45 45 45 51 31 0 0 0 0 0 0 0 0 0 0 0 0 0 0 0 0 0 0 0 0 0 0 0 0 0 0 0 0 0 
32 25 49 45 57 50 50 50 50 50 50 50 50 50 50 50 50 50 50 50 50 55 26 30 3 3 34 41 41 41 41 41 41 41 41 41 39 19 58 58 58 58 58 58 58 58 58 19 38 42 42 42 42 35 17 17 17 17 31 49 45 45 45 45 45 45 45 45 47 51 31 0 0 0 0 0 0 0 0 0 0 0 0 0 0 0 0 0 0 0 0 0 0 0 0 0 0 0 0 0 
21 25 49 45 51 27 24 29 24 29 24 24 24 24 29 29 24 24 24 29 24 24 21 30 17 17 17 17 17 3 3 3 12 17 17 17 34 41 41 41 41 41 41 39 19 58 58 58 19 58 58 58 19 38 35 17 3 17 26 53 50 50 50 50 50 50 50 50 50 55 26 0 0 0 0 0 0 0 0 0 0 0 0 0 0 0 0 0 0 0 0 0 0 0 0 0 0 0 0 0 
21 30 49 45 51 26 21 21 21 21 21 32 21 21 21 21 21 32 21 21 21 21 21 25 17 17 17 16 17 17 3 17 17 16 17 17 17 16 17 17 16 17 17 34 39 58 58 58 58 58 19 58 58 19 38 42 35 17 31 32 21 32 21 21 21 32 32 32 21 21 21 0 0 0 0 0 0 0 0 0 0 0 0 0 0 0 0 0 0 0 0 0 0 0 0 0 0 0 0 0 
21 21 28 45 22 21 32 32 32 32 21 21 21 32 32 21 21 32 32 21 21 32 21 30 17 16 17 17 17 16 17 3 17 17 17 16 16 17 17 16 17 16 17 3 34 41 39 19 58 58 58 58 58 58 58 19 38 35 3 17 17 17 12 12 17 17 3 17 12 17 17 0 0 0 0 0 0 0 0 0 0 0 0 0 0 0 0 0 0 0 0 0 0 0 0 0 0 0 0 0 
17 1 18 18 18 18 18 18 18 18 18 18 18 18 18 18 18 18 18 18 18 18 18 18 18 18 18 18 18 18 18 18 18 18 18 18 18 18 18 18 18 18 18 4 17 17 34 39 19 58 58 58 58 58 58 58 19 38 35 17 16 17 17 17 16 17 17 17 17 17 17 0 0 0 0 0 0 0 0 0 0 0 0 0 0 0 0 0 0 0 0 0 0 0 0 0 0 0 0 0 
17 14 8 8 8 8 8 8 8 8 8 8 8 8 20 8 8 8 20 20 20 8 20 20 8 8 8 8 20 8 8 8 8 8 8 8 20 8 8 2 9 9 5 11 4 3 17 34 41 41 41 39 19 58 58 58 58 58 38 42 35 17 3 17 17 16 17 17 16 17 17 0 0 0 0 0 0 0 0 0 0 0 0 0 0 0 0 0 0 0 0 0 0 0 0 0 0 0 0 0 
17 14 8 2 9 9 5 2 9 5 8 8 8 8 8 2 9 9 9 9 9 9 5 20 8 8 20 8 8 8 8 8 8 8 20 20 20 2 9 6 17 17 10 5 11 4 17 17 17 17 17 34 39 19 58 58 58 58 19 58 38 42 42 35 13 17 3 17 17 16 17 0 0 0 0 0 0 0 0 0 0 0 0 0 0 0 0 0 0 0 0 0 0 0 0 0 0 0 0 0 
3 10 9 6 12 3 10 6 12 14 20 8 20 2 9 6 17 17 3 16 16 17 10 9 9 5 8 8 8 8 20 8 8 8 8 8 2 6 16 3 17 17 16 10 5 11 18 18 18 4 17 17 34 41 41 39 19 58 58 58 58 58 58 38 42 42 35 17 12 17 17 0 0 0 0 0 0 0 0 0 0 0 0 0 0 0 0 0 0 0 0 0 0 0 0 0 0 0 0 0 
17 16 16 3 16 17 17 3 17 14 8 8 2 6 3 16 17 3 17 16 16 17 17 16 3 10 5 8 8 20 20 8 20 8 8 8 15 3 16 16 3 17 1 18 7 8 20 8 8 11 4 17 3 17 17 34 39 58 58 58 58 19 58 58 58 19 38 42 35 17 17 0 0 0 0 0 0 0 0 0 0 0 0 0 0 0 0 0 0 0 0 0 0 0 0 0 0 0 0 0 
17 17 3 3 16 17 16 3 17 14 8 20 15 12 3 17 3 17 17 3 3 17 17 17 17 12 14 20 2 9 9 9 5 8 8 8 15 16 3 17 17 17 14 8 2 9 9 5 8 8 11 18 18 18 4 17 34 39 58 58 58 58 58 58 58 58 19 58 38 42 42 0 0 0 0 0 0 0 0 0 0 0 0 0 0 0 0 0 0 0 0 0 0 0 0 0 0 0 0 0 
3 3 1 18 18 4 3 12 3 14 8 8 11 4 17 17 3 16 17 3 17 17 16 17 17 1 7 20 15 12 3 3 14 20 8 8 11 4 3 3 3 12 14 8 15 1 4 14 20 2 9 9 5 8 11 4 17 34 39 19 19 58 58 58 58 58 58 58 58 58 19 0 0 0 0 0 0 0 0 0 0 0 0 0 0 0 0 0 0 0 0 0 0 0 0 0 0 0 0 0 
16 1 7 20 8 11 18 18 18 7 8 8 8 11 18 4 12 16 3 3 1 4 12 1 18 7 8 20 15 3 17 3 14 8 8 8 8 11 18 18 18 18 7 20 15 10 6 14 8 15 13 3 14 8 8 11 4 17 34 41 41 41 41 41 39 19 58 58 58 58 19 0 0 0 0 0 0 0 0 0 0 0 0 0 0 0 0 0 0 0 0 0 0 0 0 0 0 0 0 0 
17 14 8 8 20 8 8 8 8 8 20 8 20 8 8 11 18 18 18 18 7 11 18 7 8 8 20 8 15 16 16 17 14 8 8 8 8 20 20 20 8 20 8 20 11 18 18 7 20 15 17 16 10 5 20 8 11 4 17 17 16 16 17 17 34 41 41 41 41 41 41 0 0 0 0 0 0 0 0 0 0 0 0 0 0 0 0 0 0 0 0 0 0 0 0 0 0 0 0 0 
17 14 20 2 9 9 5 8 2 5 8 8 2 9 9 9 9 9 9 9 9 9 5 8 20 20 8 8 15 12 17 17 14 8 20 2 9 9 9 9 9 5 8 8 20 8 20 8 2 6 3 16 3 10 5 20 8 11 18 18 18 18 18 4 17 17 17 17 17 17 17 0 0 0 0 0 0 0 0 0 0 0 0 0 0 0 0 0 0 0 0 0 0 0 0 0 0 0 0 0 
17 14 8 15 3 3 14 8 11 7 8 2 6 17 3 16 17 3 17 16 16 3 14 20 2 5 8 2 6 17 17 17 10 5 8 15 12 17 16 16 12 10 5 8 8 8 8 2 6 17 16 16 17 3 10 9 5 8 20 8 8 20 8 11 18 18 18 18 18 4 17 0 0 0 0 0 0 0 0 0 0 0 0 0 0 0 0 0 0 0 0 0 0 0 0 0 0 0 0 0 
17 14 2 6 17 3 10 5 8 20 8 15 3 16 17 17 17 17 16 17 17 3 14 20 15 14 8 15 12 17 3 3 1 7 8 15 13 3 17 16 17 3 14 20 8 8 2 6 16 16 16 17 17 16 17 13 14 20 20 20 2 9 9 9 9 5 20 20 20 15 17 0 0 0 0 0 0 0 0 0 0 0 0 0 0 0 0 0 0 0 0 0 0 0 0 0 0 0 0 0 
16 14 15 3 17 16 3 14 20 8 8 11 4 12 17 17 3 17 17 3 3 17 14 8 15 14 20 11 18 4 12 1 7 8 20 15 3 17 17 17 16 17 14 8 8 8 15 3 16 17 17 16 17 16 3 12 14 8 20 8 15 3 3 17 17 10 9 9 9 6 17 0 0 0 0 0 0 0 0 0 0 0 0 0 0 0 0 0 0 0 0 0 0 0 0 0 0 0 0 0 
3 14 15 3 16 17 3 14 8 20 20 8 11 18 4 13 12 13 12 1 18 18 7 8 11 7 8 8 8 11 18 7 8 20 8 11 4 16 17 17 17 16 14 8 20 20 15 3 17 3 17 17 17 3 17 13 14 20 20 8 15 17 17 17 16 3 17 3 17 17 17 0 0 0 0 0 0 0 0 0 0 0 0 0 0 0 0 0 0 0 0 0 0 0 0 0 0 0 0 0 
16 14 11 4 16 17 1 7 8 8 20 8 8 8 11 18 18 18 18 7 8 20 8 20 8 8 8 20 20 8 8 20 8 20 20 8 15 16 17 16 16 17 14 20 8 20 11 4 12 3 16 3 3 3 12 13 14 8 20 20 15 17 17 16 17 17 17 17 16 17 17 0 0 0 0 0 0 0 0 0 0 0 0 0 0 0 0 0 0 0 0 0 0 0 0 0 0 0 0 0 
17 10 9 6 17 17 10 9 9 9 9 9 5 20 20 8 8 8 8 8 8 20 20 8 8 20 20 20 8 20 20 20 20 8 8 8 15 3 16 17 3 1 7 20 20 20 8 11 18 18 18 18 18 18 18 18 7 8 20 8 15 16 16 16 17 17 17 17 16 17 17 0 0 0 0 0 0 0 0 0 0 0 0 0 0 0 0 0 0 0 0 0 0 0 0 0 0 0 0 0 
17 16 17 17 17 16 17 17 17 16 16 17 10 5 8 2 5 8 2 9 9 9 9 9 9 9 9 9 9 9 5 8 8 20 20 8 11 18 18 18 18 7 8 8 20 20 8 8 20 20 20 8 8 20 8 20 20 8 20 8 15 3 16 17 17 16 16 17 16 3 17 0 0 0 0 0 0 0 0 0 0 0 0 0 0 0 0 0 0 0 0 0 0 0 0 0 0 0 0 0 
3 3 12 3 16 12 3 17 16 16 16 3 12 14 20 15 14 8 15 3 16 17 17 16 17 17 16 17 17 17 10 5 8 20 20 20 20 8 20 20 8 20 8 8 8 20 8 20 8 8 8 8 20 8 20 20 8 8 8 20 15 16 17 17 17 16 17 17 3 17 17 0 0 0 0 0 0 0 0 0 0 0 0 0 0 0 0 0 0 0 0 0 0 0 0 0 0 0 0 0 
17 16 3 16 17 17 16 3 3 16 17 3 13 14 20 15 14 20 15 3 3 17 17 3 17 3 17 16 17 17 17 14 8 8 8 8 8 8 8 20 8 8 20 2 5 20 8 20 8 2 9 9 9 5 8 20 2 5 8 20 15 17 17 16 1 18 18 4 16 17 17 0 0 0 0 0 0 0 0 0 0 0 0 0 0 0 0 0 0 0 0 0 0 0 0 0 0 0 0 0 
16 17 3 17 3 16 16 17 3 3 16 17 1 7 8 15 14 20 11 18 18 4 17 3 17 16 16 17 16 17 16 14 8 20 8 2 9 9 9 9 5 8 20 15 14 20 2 9 9 6 17 12 3 10 5 20 15 14 20 8 15 16 17 16 14 8 20 15 17 17 17 0 0 0 0 0 0 0 0 0 0 0 0 0 0 0 0 0 0 0 0 0 0 0 0 0 0 0 0 0 
17 17 16 17 17 17 17 17 16 3 17 17 14 8 2 6 14 8 20 20 8 15 17 17 3 16 17 17 16 17 17 14 8 20 2 6 17 3 16 16 10 5 20 11 7 20 15 17 17 17 16 17 17 3 14 20 15 14 20 20 15 13 16 17 14 20 8 15 3 17 17 0 0 0 0 0 0 0 0 0 0 0 0 0 0 0 0 0 0 0 0 0 0 0 0 0 0 0 0 0 
3 16 3 17 16 17 16 17 3 17 16 17 14 8 15 1 7 2 9 9 9 6 17 17 17 17 17 16 17 17 17 14 8 20 15 3 16 17 17 16 16 14 20 20 20 20 15 17 17 3 3 17 17 17 14 20 11 7 8 20 15 16 16 16 14 8 20 15 13 17 17 0 0 0 0 0 0 0 0 0 0 0 0 0 0 0 0 0 0 0 0 0 0 0 0 0 0 0 0 0 
16 3 17 16 3 17 17 3 16 17 16 17 14 20 15 14 8 15 13 3 3 3 16 17 17 16 16 16 17 17 3 14 20 8 15 16 17 17 17 3 3 14 8 20 8 2 6 3 16 16 17 16 17 17 14 8 8 20 20 8 11 18 18 18 7 20 20 15 3 17 17 0 0 0 0 0 0 0 0 0 0 0 0 0 0 0 0 0 0 0 0 0 0 0 0 0 0 0 0 0 
3 3 17 17 17 16 3 17 3 3 17 17 14 20 15 14 20 15 12 16 3 17 17 3 3 17 17 17 17 3 3 14 20 20 15 16 17 17 16 16 3 14 8 20 20 15 3 3 16 3 17 17 17 17 14 20 8 20 20 20 8 20 20 8 20 20 8 15 3 3 17 0 0 0 0 0 0 0 0 0 0 0 0 0 0 0 0 0 0 0 0 0 0 0 0 0 0 0 0 0 
3 16 16 17 17 3 16 16 3 17 17 17 14 20 11 7 8 15 13 12 16 17 17 16 17 1 18 18 18 18 18 7 8 20 11 4 3 12 1 18 18 7 8 20 20 15 12 16 17 3 16 16 16 12 14 20 20 20 8 20 2 9 9 9 5 20 20 11 4 3 17 0 0 0 0 0 0 0 0 0 0 0 0 0 0 0 0 0 0 0 0 0 0 0 0 0 0 0 0 0 
17 17 17 3 17 3 3 3 17 16 17 16 14 20 20 20 8 15 13 16 3 16 16 16 13 14 8 20 20 8 8 20 8 20 8 11 18 18 7 20 8 20 8 20 8 15 13 17 16 17 3 16 16 17 10 9 9 5 8 20 15 3 16 3 14 8 8 20 15 17 17 0 0 0 0 0 0 0 0 0 0 0 0 0 0 0 0 0 0 0 0 0 0 0 0 0 0 0 0 0 
17 12 13 12 13 12 13 13 1 18 18 18 7 8 8 8 8 11 18 18 18 18 18 18 18 7 8 8 20 20 8 20 20 8 20 20 20 20 8 20 8 8 20 20 8 15 12 16 17 17 17 3 17 17 16 16 16 14 20 8 15 3 16 16 14 8 20 20 15 17 17 0 0 0 0 0 0 0 0 0 0 0 0 0 0 0 0 0 0 0 0 0 0 0 0 0 0 0 0 0 
17 1 18 18 18 18 18 18 7 8 8 8 8 8 8 20 20 8 8 20 8 20 20 8 20 20 20 20 2 9 9 9 9 9 9 5 8 20 20 8 20 20 8 8 8 15 13 3 3 16 16 17 17 17 17 16 3 14 20 20 15 16 3 17 14 20 20 8 15 3 17 0 0 0 0 0 0 0 0 0 0 0 0 0 0 0 0 0 0 0 0 0 0 0 0 0 0 0 0 0 
17 14 8 20 8 8 20 8 8 8 20 8 8 8 8 20 8 20 8 20 20 20 2 5 20 2 9 9 6 3 16 16 12 16 16 10 9 9 9 9 9 5 8 8 2 6 3 17 17 16 1 18 18 18 18 18 18 7 8 8 15 17 17 17 14 20 8 20 15 3 17 0 0 0 0 0 0 0 0 0 0 0 0 0 0 0 0 0 0 0 0 0 0 0 0 0 0 0 0 0 
17 14 8 8 20 8 8 8 8 8 8 8 2 9 9 9 9 9 9 9 5 8 11 7 20 15 3 16 17 16 3 16 16 17 3 17 3 17 17 3 17 14 8 20 15 16 16 17 17 1 7 8 20 8 20 8 20 8 8 20 15 3 17 3 14 8 8 2 6 16 17 0 0 0 0 0 0 0 0 0 0 0 0 0 0 0 0 0 0 0 0 0 0 0 0 0 0 0 0 0 
17 14 8 2 9 9 9 5 8 20 8 2 6 17 17 17 12 13 16 3 10 5 8 20 20 15 3 3 17 17 17 16 17 17 3 17 17 17 3 17 17 14 8 8 15 16 16 17 17 14 8 20 2 9 9 9 5 8 20 20 11 18 18 18 20 20 20 15 3 16 17 0 0 0 0 0 0 0 0 0 0 0 0 0 0 0 0 0 0 0 0 0 0 0 0 0 0 0 0 0 
17 14 2 6 3 16 3 14 8 8 8 15 17 17 3 17 17 16 16 16 17 14 8 20 8 11 18 18 18 4 17 16 17 1 18 18 18 4 3 13 1 7 8 20 15 17 17 16 16 14 8 20 15 3 16 16 14 20 20 8 20 20 20 8 20 8 20 15 3 3 17 0 0 0 0 0 0 0 0 0 0 0 0 0 0 0 0 0 0 0 0 0 0 0 0 0 0 0 0 0 
17 14 15 3 16 16 16 10 5 20 8 15 17 3 17 17 17 17 16 16 3 14 20 8 20 20 8 8 8 15 3 17 17 14 20 20 8 11 18 18 7 8 20 20 15 17 17 16 3 14 20 20 15 16 16 3 14 20 20 20 8 20 8 20 20 8 20 15 17 17 17 0 0 0 0 0 0 0 0 0 0 0 0 0 0 0 0 0 0 0 0 0 0 0 0 0 0 0 0 0 
17 14 15 12 3 16 16 12 14 8 8 15 3 3 16 16 16 17 17 17 3 14 8 20 20 2 9 5 8 15 16 17 17 14 8 20 8 20 20 20 8 20 20 8 11 18 18 18 18 7 8 20 15 3 3 3 14 8 20 2 9 9 9 9 5 20 8 15 16 16 17 0 0 0 0 0 0 0 0 0 0 0 0 0 0 0 0 0 0 0 0 0 0 0 0 0 0 0 0 0 
17 10 6 16 3 16 3 13 14 8 8 15 17 3 16 3 3 17 16 3 17 14 8 8 2 6 3 14 20 15 17 17 16 10 9 9 5 8 8 20 20 20 20 20 20 8 20 20 20 20 8 20 15 16 17 3 10 9 9 6 12 3 3 12 10 9 9 6 17 16 17 0 0 0 0 0 0 0 0 0 0 0 0 0 0 0 0 0 0 0 0 0 0 0 0 0 0 0 0 0 
17 3 17 17 16 16 16 17 10 9 9 6 17 17 16 16 17 17 16 17 17 10 9 9 6 3 3 10 9 6 16 16 17 17 17 13 10 9 9 9 9 9 9 9 9 9 9 9 9 9 9 9 6 16 17 17 17 3 17 16 3 17 16 16 17 3 17 17 16 17 17 0 0 0 0 0 0 0 0 0 0 0 0 0 0 0 0 0 0 0 0 0 0 0 0 0 0 0 0 0 
17 17 17 17 3 16 16 17 17 17 17 17 17 17 17 17 17 17 17 17 17 17 17 17 17 17 17 17 17 17 17 17 17 17 17 17 17 17 17 17 17 17 17 17 17 17 17 17 17 17 17 17 17 17 17 17 17 17 17 17 17 17 17 17 17 17 17 17 17 17 17 0 0 0 0 0 0 0 0 0 0 0 0 0 0 0 0 0 0 0 0 0 0 0 0 0 0 0 0 0 
0 0 0 0 0 0 0 0 0 0 0 0 0 0 0 0 0 0 0 0 0 0 0 0 0 0 0 0 0 0 0 0 0 0 0 0 0 0 0 0 0 0 0 0 0 0 0 0 0 0 0 0 0 0 0 0 0 0 0 0 0 0 0 0 0 0 0 0 0 0 0 0 0 0 0 0 0 0 0 0 0 0 0 0 0 0 0 0 0 0 0 0 0 0 0 0 0 0 0 0 
0 0 0 0 0 0 0 0 0 0 0 0 0 0 0 0 0 0 0 0 0 0 0 0 0 0 0 0 0 0 0 0 0 0 0 0 0 0 0 0 0 0 0 0 0 0 0 0 0 0 0 0 0 0 0 0 0 0 0 0 0 0 0 0 0 0 0 0 0 0 0 0 0 0 0 0 0 0 0 0 0 0 0 0 0 0 0 0 0 0 0 0 0 0 0 0 0 0 0 0 
0 0 0 0 0 0 0 0 0 0 0 0 0 0 0 0 0 0 0 0 0 0 0 0 0 0 0 0 0 0 0 0 0 0 0 0 0 0 0 0 0 0 0 0 0 0 0 0 0 0 0 0 0 0 0 0 0 0 0 0 0 0 0 0 0 0 0 0 0 0 0 0 0 0 0 0 0 0 0 0 0 0 0 0 0 0 0 0 0 0 0 0 0 0 0 0 0 0 0 0 
0 0 0 0 0 0 0 0 0 0 0 0 0 0 0 0 0 0 0 0 0 0 0 0 0 0 0 0 0 0 0 0 0 0 0 0 0 0 0 0 0 0 0 0 0 0 0 0 0 0 0 0 0 0 0 0 0 0 0 0 0 0 0 0 0 0 0 0 0 0 0 0 0 0 0 0 0 0 0 0 0 0 0 0 0 0 0 0 0 0 0 0 0 0 0 0 0 0 0 0 
0 0 0 0 0 0 0 0 0 0 0 0 0 0 0 0 0 0 0 0 0 0 0 0 0 0 0 0 0 0 0 0 0 0 0 0 0 0 0 0 0 0 0 0 0 0 0 0 0 0 0 0 0 0 0 0 0 0 0 0 0 0 0 0 0 0 0 0 0 0 0 0 0 0 0 0 0 0 0 0 0 0 0 0 0 0 0 0 0 0 0 0 0 0 0 0 0 0 0 0 
0 0 0 0 0 0 0 0 0 0 0 0 0 0 0 0 0 0 0 0 0 0 0 0 0 0 0 0 0 0 0 0 0 0 0 0 0 0 0 0 0 0 0 0 0 0 0 0 0 0 0 0 0 0 0 0 0 0 0 0 0 0 0 0 0 0 0 0 0 0 0 0 0 0 0 0 0 0 0 0 0 0 0 0 0 0 0 0 0 0 0 0 0 0 0 0 0 0 0 0 
0 0 0 0 0 0 0 0 0 0 0 0 0 0 0 0 0 0 0 0 0 0 0 0 0 0 0 0 0 0 0 0 0 0 0 0 0 0 0 0 0 0 0 0 0 0 0 0 0 0 0 0 0 0 0 0 0 0 0 0 0 0 0 0 0 0 0 0 0 0 0 0 0 0 0 0 0 0 0 0 0 0 0 0 0 0 0 0 0 0 0 0 0 0 0 0 0 0 0 0 
0 0 0 0 0 0 0 0 0 0 0 0 0 0 0 0 0 0 0 0 0 0 0 0 0 0 0 0 0 0 0 0 0 0 0 0 0 0 0 0 0 0 0 0 0 0 0 0 0 0 0 0 0 0 0 0 0 0 0 0 0 0 0 0 0 0 0 0 0 0 0 0 0 0 0 0 0 0 0 0 0 0 0 0 0 0 0 0 0 0 0 0 0 0 0 0 0 0 0 0 
0 0 0 0 0 0 0 0 0 0 0 0 0 0 0 0 0 0 0 0 0 0 0 0 0 0 0 0 0 0 0 0 0 0 0 0 0 0 0 0 0 0 0 0 0 0 0 0 0 0 0 0 0 0 0 0 0 0 0 0 0 0 0 0 0 0 0 0 0 0 0 0 0 0 0 0 0 0 0 0 0 0 0 0 0 0 0 0 0 0 0 0 0 0 0 0 0 0 0 0 
0 0 0 0 0 0 0 0 0 0 0 0 0 0 0 0 0 0 0 0 0 0 0 0 0 0 0 0 0 0 0 0 0 0 0 0 0 0 0 0 0 0 0 0 0 0 0 0 0 0 0 0 0 0 0 0 0 0 0 0 0 0 0 0 0 0 0 0 0 0 0 0 0 0 0 0 0 0 0 0 0 0 0 0 0 0 0 0 0 0 0 0 0 0 0 0 0 0 0 0 
0 0 0 0 0 0 0 0 0 0 0 0 0 0 0 0 0 0 0 0 0 0 0 0 0 0 0 0 0 0 0 0 0 0 0 0 0 0 0 0 0 0 0 0 0 0 0 0 0 0 0 0 0 0 0 0 0 0 0 0 0 0 0 0 0 0 0 0 0 0 0 0 0 0 0 0 0 0 0 0 0 0 0 0 0 0 0 0 0 0 0 0 0 0 0 0 0 0 0 0 
0 0 0 0 0 0 0 0 0 0 0 0 0 0 0 0 0 0 0 0 0 0 0 0 0 0 0 0 0 0 0 0 0 0 0 0 0 0 0 0 0 0 0 0 0 0 0 0 0 0 0 0 0 0 0 0 0 0 0 0 0 0 0 0 0 0 0 0 0 0 0 0 0 0 0 0 0 0 0 0 0 0 0 0 0 0 0 0 0 0 0 0 0 0 0 0 0 0 0 0 
0 0 0 0 0 0 0 0 0 0 0 0 0 0 0 0 0 0 0 0 0 0 0 0 0 0 0 0 0 0 0 0 0 0 0 0 0 0 0 0 0 0 0 0 0 0 0 0 0 0 0 0 0 0 0 0 0 0 0 0 0 0 0 0 0 0 0 0 0 0 0 0 0 0 0 0 0 0 0 0 0 0 0 0 0 0 0 0 0 0 0 0 0 0 0 0 0 0 0 0 
0 0 0 0 0 0 0 0 0 0 0 0 0 0 0 0 0 0 0 0 0 0 0 0 0 0 0 0 0 0 0 0 0 0 0 0 0 0 0 0 0 0 0 0 0 0 0 0 0 0 0 0 0 0 0 0 0 0 0 0 0 0 0 0 0 0 0 0 0 0 0 0 0 0 0 0 0 0 0 0 0 0 0 0 0 0 0 0 0 0 0 0 0 0 0 0 0 0 0 0 
0 0 0 0 0 0 0 0 0 0 0 0 0 0 0 0 0 0 0 0 0 0 0 0 0 0 0 0 0 0 0 0 0 0 0 0 0 0 0 0 0 0 0 0 0 0 0 0 0 0 0 0 0 0 0 0 0 0 0 0 0 0 0 0 0 0 0 0 0 0 0 0 0 0 0 0 0 0 0 0 0 0 0 0 0 0 0 0 0 0 0 0 0 0 0 0 0 0 0 0 
0 0 0 0 0 0 0 0 0 0 0 0 0 0 0 0 0 0 0 0 0 0 0 0 0 0 0 0 0 0 0 0 0 0 0 0 0 0 0 0 0 0 0 0 0 0 0 0 0 0 0 0 0 0 0 0 0 0 0 0 0 0 0 0 0 0 0 0 0 0 0 0 0 0 0 0 0 0 0 0 0 0 0 0 0 0 0 0 0 0 0 0 0 0 0 0 0 0 0 0 
0 0 0 0 0 0 0 0 0 0 0 0 0 0 0 0 0 0 0 0 0 0 0 0 0 0 0 0 0 0 0 0 0 0 0 0 0 0 0 0 0 0 0 0 0 0 0 0 0 0 0 0 0 0 0 0 0 0 0 0 0 0 0 0 0 0 0 0 0 0 0 0 0 0 0 0 0 0 0 0 0 0 0 0 0 0 0 0 0 0 0 0 0 0 0 0 0 0 0 0 
0 0 0 0 0 0 0 0 0 0 0 0 0 0 0 0 0 0 0 0 0 0 0 0 0 0 0 0 0 0 0 0 0 0 0 0 0 0 0 0 0 0 0 0 0 0 0 0 0 0 0 0 0 0 0 0 0 0 0 0 0 0 0 0 0 0 0 0 0 0 0 0 0 0 0 0 0 0 0 0 0 0 0 0 0 0 0 0 0 0 0 0 0 0 0 0 0 0 0 0 
0 0 0 0 0 0 0 0 0 0 0 0 0 0 0 0 0 0 0 0 0 0 0 0 0 0 0 0 0 0 0 0 0 0 0 0 0 0 0 0 0 0 0 0 0 0 0 0 0 0 0 0 0 0 0 0 0 0 0 0 0 0 0 0 0 0 0 0 0 0 0 0 0 0 0 0 0 0 0 0 0 0 0 0 0 0 0 0 0 0 0 0 0 0 0 0 0 0 0 0 
0 0 0 0 0 0 0 0 0 0 0 0 0 0 0 0 0 0 0 0 0 0 0 0 0 0 0 0 0 0 0 0 0 0 0 0 0 0 0 0 0 0 0 0 0 0 0 0 0 0 0 0 0 0 0 0 0 0 0 0 0 0 0 0 0 0 0 0 0 0 0 0 0 0 0 0 0 0 0 0 0 0 0 0 0 0 0 0 0 0 0 0 0 0 0 0 0 0 0 0 
0 0 0 0 0 0 0 0 0 0 0 0 0 0 0 0 0 0 0 0 0 0 0 0 0 0 0 0 0 0 0 0 0 0 0 0 0 0 0 0 0 0 0 0 0 0 0 0 0 0 0 0 0 0 0 0 0 0 0 0 0 0 0 0 0 0 0 0 0 0 0 0 0 0 0 0 0 0 0 0 0 0 0 0 0 0 0 0 0 0 0 0 0 0 0 0 0 0 0 0 
0 0 0 0 0 0 0 0 0 0 0 0 0 0 0 0 0 0 0 0 0 0 0 0 0 0 0 0 0 0 0 0 0 0 0 0 0 0 0 0 0 0 0 0 0 0 0 0 0 0 0 0 0 0 0 0 0 0 0 0 0 0 0 0 0 0 0 0 0 0 0 0 0 0 0 0 0 0 0 0 0 0 0 0 0 0 0 0 0 0 0 0 0 0 0 0 0 0 0 0 
0 0 0 0 0 0 0 0 0 0 0 0 0 0 0 0 0 0 0 0 0 0 0 0 0 0 0 0 0 0 0 0 0 0 0 0 0 0 0 0 0 0 0 0 0 0 0 0 0 0 0 0 0 0 0 0 0 0 0 0 0 0 0 0 0 0 0 0 0 0 0 0 0 0 0 0 0 0 0 0 0 0 0 0 0 0 0 0 0 0 0 0 0 0 0 0 0 0 0 0 
0 0 0 0 0 0 0 0 0 0 0 0 0 0 0 0 0 0 0 0 0 0 0 0 0 0 0 0 0 0 0 0 0 0 0 0 0 0 0 0 0 0 0 0 0 0 0 0 0 0 0 0 0 0 0 0 0 0 0 0 0 0 0 0 0 0 0 0 0 0 0 0 0 0 0 0 0 0 0 0 0 0 0 0 0 0 0 0 0 0 0 0 0 0 0 0 0 0 0 0 
0 0 0 0 0 0 0 0 0 0 0 0 0 0 0 0 0 0 0 0 0 0 0 0 0 0 0 0 0 0 0 0 0 0 0 0 0 0 0 0 0 0 0 0 0 0 0 0 0 0 0 0 0 0 0 0 0 0 0 0 0 0 0 0 0 0 0 0 0 0 0 0 0 0 0 0 0 0 0 0 0 0 0 0 0 0 0 0 0 0 0 0 0 0 0 0 0 0 0 0 
0 0 0 0 0 0 0 0 0 0 0 0 0 0 0 0 0 0 0 0 0 0 0 0 0 0 0 0 0 0 0 0 0 0 0 0 0 0 0 0 0 0 0 0 0 0 0 0 0 0 0 0 0 0 0 0 0 0 0 0 0 0 0 0 0 0 0 0 0 0 0 0 0 0 0 0 0 0 0 0 0 0 0 0 0 0 0 0 0 0 0 0 0 0 0 0 0 0 0 0 
0 0 0 0 0 0 0 0 0 0 0 0 0 0 0 0 0 0 0 0 0 0 0 0 0 0 0 0 0 0 0 0 0 0 0 0 0 0 0 0 0 0 0 0 0 0 0 0 0 0 0 0 0 0 0 0 0 0 0 0 0 0 0 0 0 0 0 0 0 0 0 0 0 0 0 0 0 0 0 0 0 0 0 0 0 0 0 0 0 0 0 0 0 0 0 0 0 0 0 0 
0 0 0 0 0 0 0 0 0 0 0 0 0 0 0 0 0 0 0 0 0 0 0 0 0 0 0 0 0 0 0 0 0 0 0 0 0 0 0 0 0 0 0 0 0 0 0 0 0 0 0 0 0 0 0 0 0 0 0 0 0 0 0 0 0 0 0 0 0 0 0 0 0 0 0 0 0 0 0 0 0 0 0 0 0 0 0 0 0 0 0 0 0 0 0 0 0 0 0 0 
0 0 0 0 0 0 0 0 0 0 0 0 0 0 0 0 0 0 0 0 0 0 0 0 0 0 0 0 0 0 0 0 0 0 0 0 0 0 0 0 0 0 0 0 0 0 0 0 0 0 0 0 0 0 0 0 0 0 0 0 0 0 0 0 0 0 0 0 0 0 0 0 0 0 0 0 0 0 0 0 0 0 0 0 0 0 0 0 0 0 0 0 0 0 0 0 0 0 0 0 
0 0 0 0 0 0 0 0 0 0 0 0 0 0 0 0 0 0 0 0 0 0 0 0 0 0 0 0 0 0 0 0 0 0 0 0 0 0 0 0 0 0 0 0 0 0 0 0 0 0 0 0 0 0 0 0 0 0 0 0 0 0 0 0 0 0 0 0 0 0 0 0 0 0 0 0 0 0 0 0 0 0 0 0 0 0 0 0 0 0 0 0 0 0 0 0 0 0 0 0 
0 0 0 0 0 0 0 0 0 0 0 0 0 0 0 0 0 0 0 0 0 0 0 0 0 0 0 0 0 0 0 0 0 0 0 0 0 0 0 0 0 0 0 0 0 0 0 0 0 0 0 0 0 0 0 0 0 0 0 0 0 0 0 0 0 0 0 0 0 0 0 0 0 0 0 0 0 0 0 0 0 0 0 0 0 0 0 0 0 0 0 0 0 0 0 0 0 0 0 0 
0 0 0 0 0 0 0 0 0 0 0 0 0 0 0 0 0 0 0 0 0 0 0 0 0 0 0 0 0 0 0 0 0 0 0 0 0 0 0 0 0 0 0 0 0 0 0 0 0 0 0 0 0 0 0 0 0 0 0 0 0 0 0 0 0 0 0 0 0 0 0 0 0 0 0 0 0 0 0 0 0 0 0 0 0 0 0 0 0 0 0 0 0 0 0 0 0 0 0 0 
0 0 0 0 0 0 0 0 0 0 0 0 0 0 0 0 0 0 0 0 0 0 0 0 0 0 0 0 0 0 0 0 0 0 0 0 0 0 0 0 0 0 0 0 0 0 0 0 0 0 0 0 0 0 0 0 0 0 0 0 0 0 0 0 0 0 0 0 0 0 0 0 0 0 0 0 0 0 0 0 0 0 0 0 0 0 0 0 0 0 0 0 0 0 0 0 0 0 0 0 
0 0 0 0 0 0 0 0 0 0 0 0 0 0 0 0 0 0 0 0 0 0 0 0 0 0 0 0 0 0 0 0 0 0 0 0 0 0 0 0 0 0 0 0 0 0 0 0 0 0 0 0 0 0 0 0 0 0 0 0 0 0 0 0 0 0 0 0 0 0 0 0 0 0 0 0 0 0 0 0 0 0 0 0 0 0 0 0 0 0 0 0 0 0 0 0 0 0 0 0 
0 0 0 0 0 0 0 0 0 0 0 0 0 0 0 0 0 0 0 0 0 0 0 0 0 0 0 0 0 0 0 0 0 0 0 0 0 0 0 0 0 0 0 0 0 0 0 0 0 0 0 0 0 0 0 0 0 0 0 0 0 0 0 0 0 0 0 0 0 0 0 0 0 0 0 0 0 0 0 0 0 0 0 0 0 0 0 0 0 0 0 0 0 0 0 0 0 0 0 0 
0 0 0 0 0 0 0 0 0 0 0 0 0 0 0 0 0 0 0 0 0 0 0 0 0 0 0 0 0 0 0 0 0 0 0 0 0 0 0 0 0 0 0 0 0 0 0 0 0 0 0 0 0 0 0 0 0 0 0 0 0 0 0 0 0 0 0 0 0 0 0 0 0 0 0 0 0 0 0 0 0 0 0 0 0 0 0 0 0 0 0 0 0 0 0 0 0 0 0 0 
0 0 0 0 0 0 0 0 0 0 0 0 0 0 0 0 0 0 0 0 0 0 0 0 0 0 0 0 0 0 0 0 0 0 0 0 0 0 0 0 0 0 0 0 0 0 0 0 0 0 0 0 0 0 0 0 0 0 0 0 0 0 0 0 0 0 0 0 0 0 0 0 0 0 0 0 0 0 0 0 0 0 0 0 0 0 0 0 0 0 0 0 0 0 0 0 0 0 0 0 
0 0 0 0 0 0 0 0 0 0 0 0 0 0 0 0 0 0 0 0 0 0 0 0 0 0 0 0 0 0 0 0 0 0 0 0 0 0 0 0 0 0 0 0 0 0 0 0 0 0 0 0 0 0 0 0 0 0 0 0 0 0 0 0 0 0 0 0 0 0 0 0 0 0 0 0 0 0 0 0 0 0 0 0 0 0 0 0 0 0 0 0 0 0 0 0 0 0 0 0 
0 0 0 0 0 0 0 0 0 0 0 0 0 0 0 0 0 0 0 0 0 0 0 0 0 0 0 0 0 0 0 0 0 0 0 0 0 0 0 0 0 0 0 0 0 0 0 0 0 0 0 0 0 0 0 0 0 0 0 0 0 0 0 0 0 0 0 0 0 0 0 0 0 0 0 0 0 0 0 0 0 0 0 0 0 0 0 0 0 0 0 0 0 0 0 0 0 0 0 0 
0 0 0 0 0 0 0 0 0 0 0 0 0 0 0 0 0 0 0 0 0 0 0 0 0 0 0 0 0 0 0 0 0 0 0 0 0 0 0 0 0 0 0 0 0 0 0 0 0 0 0 0 0 0 0 0 0 0 0 0 0 0 0 0 0 0 0 0 0 0 0 0 0 0 0 0 0 0 0 0 0 0 0 0 0 0 0 0 0 0 0 0 0 0 0 0 0 0 0 0 
0 0 0 0 0 0 0 0 0 0 0 0 0 0 0 0 0 0 0 0 0 0 0 0 0 0 0 0 0 0 0 0 0 0 0 0 0 0 0 0 0 0 0 0 0 0 0 0 0 0 0 0 0 0 0 0 0 0 0 0 0 0 0 0 0 0 0 0 0 0 0 0 0 0 0 0 0 0 0 0 0 0 0 0 0 0 0 0 0 0 0 0 0 0 0 0 0 0 0 0 
0 0 0 0 0 0 0 0 0 0 0 0 0 0 0 0 0 0 0 0 0 0 0 0 0 0 0 0 0 0 0 0 0 0 0 0 0 0 0 0 0 0 0 0 0 0 0 0 0 0 0 0 0 0 0 0 0 0 0 0 0 0 0 0 0 0 0 0 0 0 0 0 0 0 0 0 0 0 0 0 0 0 0 0 0 0 0 0 0 0 0 0 0 0 0 0 0 0 0 0 
0 0 0 0 0 0 0 0 0 0 0 0 0 0 0 0 0 0 0 0 0 0 0 0 0 0 0 0 0 0 0 0 0 0 0 0 0 0 0 0 0 0 0 0 0 0 0 0 0 0 0 0 0 0 0 0 0 0 0 0 0 0 0 0 0 0 0 0 0 0 0 0 0 0 0 0 0 0 0 0 0 0 0 0 0 0 0 0 0 0 0 0 0 0 0 0 0 0 0 0 
0 0 0 0 0 0 0 0 0 0 0 0 0 0 0 0 0 0 0 0 0 0 0 0 0 0 0 0 0 0 0 0 0 0 0 0 0 0 0 0 0 0 0 0 0 0 0 0 0 0 0 0 0 0 0 0 0 0 0 0 0 0 0 0 0 0 0 0 0 0 0 0 0 0 0 0 0 0 0 0 0 0 0 0 0 0 0 0 0 0 0 0 0 0 0 0 0 0 0 0 
0 0 0 0 0 0 0 0 0 0 0 0 0 0 0 0 0 0 0 0 0 0 0 0 0 0 0 0 0 0 0 0 0 0 0 0 0 0 0 0 0 0 0 0 0 0 0 0 0 0 0 0 0 0 0 0 0 0 0 0 0 0 0 0 0 0 0 0 0 0 0 0 0 0 0 0 0 0 0 0 0 0 0 0 0 0 0 0 0 0 0 0 0 0 0 0 0 0 0 0 
0 0 0 0 0 0 0 0 0 0 0 0 0 0 0 0 0 0 0 0 0 0 0 0 0 0 0 0 0 0 0 0 0 0 0 0 0 0 0 0 0 0 0 0 0 0 0 0 0 0 0 0 0 0 0 0 0 0 0 0 0 0 0 0 0 0 0 0 0 0 0 0 0 0 0 0 0 0 0 0 0 0 0 0 0 0 0 0 0 0 0 0 0 0 0 0 0 0 0 0 
0 0 0 0 0 0 0 0 0 0 0 0 0 0 0 0 0 0 0 0 0 0 0 0 0 0 0 0 0 0 0 0 0 0 0 0 0 0 0 0 0 0 0 0 0 0 0 0 0 0 0 0 0 0 0 0 0 0 0 0 0 0 0 0 0 0 0 0 0 0 0 0 0 0 0 0 0 0 0 0 0 0 0 0 0 0 0 0 0 0 0 0 0 0 0 0 0 0 0 0 
0 0 0 0 0 0 0 0 0 0 0 0 0 0 0 0 0 0 0 0 0 0 0 0 0 0 0 0 0 0 0 0 0 0 0 0 0 0 0 0 0 0 0 0 0 0 0 0 0 0 0 0 0 0 0 0 0 0 0 0 0 0 0 0 0 0 0 0 0 0 0 0 0 0 0 0 0 0 0 0 0 0 0 0 0 0 0 0 0 0 0 0 0 0 0 0 0 0 0 0 
0 0 0 0 0 0 0 0 0 0 0 0 0 0 0 0 0 0 0 0 0 0 0 0 0 0 0 0 0 0 0 0 0 0 0 0 0 0 0 0 0 0 0 0 0 0 0 0 0 0 0 0 0 0 0 0 0 0 0 0 0 0 0 0 0 0 0 0 0 0 0 0 0 0 0 0 0 0 0 0 0 0 0 0 0 0 0 0 0 0 0 0 0 0 0 0 0 0 0 0 
